<<<<동양>>>>

<단도>
마키리 - 아이누족의 전통적인 칼. 마키리 자체가 아이누어로 칼이라는 의미이다. 여성용은 메노코마키리(メノコマキリ)라고 하며, 메노코(メノコ)라는 단어가 아이누어로 여자를 의미한다.
자마다르 - 인도에서 사용된 단검의 일종으로 서양권에 전파되어 서양에서는 자마다르를 '카타르'라 부름
장도 - 長刀가 아니다. 칼집이 있는 작은 칼을 말하며, 허리춤에 차고 옷고름에 찬다 하여 패도(佩刀), 주머니에 넣고 다닌다 하여 낭도(囊刀)라고도 불렀다.
와키자시 - 날 길이는 1척(30.3cm)에서 2척(60.6cm) 사이, 보통 40~50cm 정도로 타치나 코다치, 우치가타나에 비해서 다소 짧은 칼이다. 
탄토 - 탄토(短刀)란, 날 길이 1척(30, 3cm) 이하의 일본도의 총칭이다. 국내에서는 단도라고도 널리 불린다.
카람빗 - 말레이시아와 필리핀을 뿌리로 인도네시아 군도, 정확히는 술라웨시 서부에서 탄생한 유명한 다용도 나이프로 고대 원주민의 일상용 포켓나이프였다.
쿠나이 - 닌자들이 사용했다고 알려진 무기. 성인 남성 손바닥만한 길이의 단검 손잡이 끝에 고리가 달린 형태를 하고 있다. 흔히 수리검으로 오해받기도 하는데, 본고장인 일본에서도 쿠나이 수리검이라고 불리는 경우가 종종 있다.
쿠크리 - 네팔 구르카족의 전통 도검. Kukri가 가장 보편화되었지만 Khukri, Khukuri 등으로 적기도 한다.
크리스 - 기본적으로 말레이시아와 인도네시아 등지의 검으로, 물결처럼 구불구불한 모양의 특이한 날을 가진 도검

<도>
월도 - 월도(月刀)는 외날에 긴 자루를 가진 도(刀) 계열의 무기를 일컫는다. 고전 한문에서 반달을 언월(偃月)이라고도 하기 때문에, '반달 칼'이라는 뜻으로 언월도(偃月刀)라고 부르기도 한다.
일본도 - 타치(太刀)나 우치가타나(打刀) 등을 포함하는 일본의 전통 도검이다. 참고로 츠루기(剣)는 양날검을 특별히 일컫는 호칭이다. 다른 나라에서는 왜도(倭刀), 왜검(倭劍)으로 부르기도 했다.
환도 - 한반도 지역 국가들의 전통 무기로, 고리를 사용하여 패용(佩用)하였던 도검(刀劍)들을 일컫는다. 한민족이 횡도(환두대도) 다음으로 오랫동안 사용한 군사 도검이다.
환두대도 - 대한민국 역사에서 가장 오랫동안 사용한 군사 도검이다. 오랜 세월이 흐르며 약간씩 형태 변화는 있었더라도 원삼국시대부터 고려시대까지 폭 넓게 주력으로 사용하였으며, 칼날 휨을 추가한 환도를 주로 사용한 조선시대 때도 여전히 이와 비슷한 장도는 존재했다.

<둔기>
간 - 중국의 병장기. 간혹 簡이라고 쓰기도 한다. 편과 사촌격인 일종의 각진 몽둥이로, 역시 철로 만들고 무게도 제법 묵직하여 사람의 머리 정도는 손쉽게 아작낸다. 
금쇄봉 - 중세 일본의 철퇴 중 하나. 카나사이보라고 읽으며, 테츠보(鉄棒), 혹은 카나보(金棒)라고도 불린다.
철퇴(메이스) - 철퇴(鐵槌)는 병장기의 하나로, 막대끝에 돌기나 무게추가 달려있어 한손으로 휘두를 수 있는 몽둥이다. 철추(鐵椎)라고도 한다. 우리말로는 쇠몽둥이.
철편 - 철편(鐵鞭)은 회초리와 비슷하게 생긴 타격 무기의 일종이다.
톤파 - 중국 拐(괴) 단봉형 무기가 오키나와에 와서 변형되어 오키나와에서 유래한 날없는 타격 무기다.

<창>
극 - 戟. 중국의 고대 폴암으로 긴 손잡이 끝에 단검이 붙었고 그보다 조금 밑에 보조날이 달린 무기.
나기나타 - 일본 헤이안 시대부터 쓰이기 시작한 전근대 장병도(長柄刀) 계열 무기이며, 장병기의 일종이다. 외형은 언월도나 글레이브, 협도 등과 흡사하지만, 나기나타가 더 가볍고 얇기에, 운용 방식에서는 차이가 난다. 
당파 - 무기의 일종, 삼지창처럼 생겼으나 좌우의 가지 부분이 옆으로 갈라지는 형태로 생겼다. 조선시대 사극을 보면 포졸이건 군졸이건 할 것 없이 꼭 이 무기를 들고 나온다. 실제로는 포졸이 의장용으로 쓰는 경우를 제외하면 평시에 들고 다닐 일은 없는 무기다.
죽창 - 죽창(竹槍)은 대나무로 만든 창을 말한다. 대창이라고도 불린다. 영어로는 Bamboo Spear, 일본어로는 타케야리(たけやり, 한자로는 竹槍).

<투척>
차크람 - 시크교 신도의 전통 투척 무기, 산스크리트어로 '둥근', '원', '바퀴' 등을 뜻하는 차크라에서 유래하였다. "챠카"라고도 부른다.
수리검 - 던져서 적을 맞히는 것을 목적으로 하는 표창 계열의 무기. 보통 표창이라고 통칭하며 넓은 의미에서는 표창이 맞기 때문에 틀린 건 아니다. 手(손 수)에 裏(속 리)를 써서 '손안에 감춘 칼'이라는 뜻이다.

<투사>
쇠뇌 - 활을 사람의 힘으로 당기지 않고 고정틀에 물리고 화살을 올려 발사장치를 통해 쏘는 기계식 활.

<기타> 
철선 - Iron Fan. War Fan. 쇠로 만든 부채. 믿기 어렵겠지만 무기이다. 


<<<<서양>>>>

<도>
글라디우스 - 글라디우스는 로마군의 대표적인 한손검이다. 로마군의 표준 제식 무장이자 주력 무기였다. 
레이피어 - 16~17세기 유럽에서 사용된 검으로 베기보다는 찌르기에 특화된 형태의 검.
세이버 - 근대 유럽을 대표하는 기병용 장검. 주로 한손으로 쓰는 휘어진 외날도(刀)로 알려져 있다. 군용 외에 스포츠화 된 펜싱에서 프랑스 발음인 사브르로 불리며 한 종목으로 자리잡아 있다.
시미터 - 중동에서 기원한 곡도를 일컫는 말. 흔히 초승달처럼 휘어있는 곡률이 큰 중동제 곡도라고 말하지만……. 한자로는 신월도(新月刀)라고 표기한다.
브로드소드 - 중국의 도(刀, Dao)를 영어로 번역할 때 브로드소드라고 하는 경우도 종종 있다. 여기서는 유럽의 브로드소드만을 다룬다.

팔카타 - 그리스의 중장보병 호플리테스들이 즐겨 쓴 검.

<양손검>
롱소드 - 유럽에서 쓰인 양날 양손 도검이다.
바스타드소드 - 폭의 변화가 매우 큰(테이퍼진) 검신을 지닌 롱소드
그레이트소드 - 그레이트소드는 말 그대로 대검이라는 의미. 대검이라는 것 외에 단어가 특정짓는 특징은 없다.
익스큐셔너소드(참수도) - 이름 그대로 사형집행인들이 죄인을 참수형에 처할때 쓰기 위해 특별히 만들어진 도검이다.
츠바이헨더 - 르네상스 시대, 16세기경에 주로 사용된 독일제 트루 투핸더를 말한다. 당대에 사용되던 각국의 투핸디드 소드와 마찬가지로 양손으로만 사용 가능한 엄청나게 큰 양손검이다.
클레이보어 - 어원은 스코틀랜드 게일어 'claidheamh-mòr'[1]로, '거대한 검(great sword)'이라는 뜻이다. 15세기에서 17세기까지 스코틀랜드의 하이랜더들이 사용한 것으로 유명하다.
플랑베르주 - 서양의 도검류 중 한 종류로, 물결치는 형태의 날을 가진 검이다. '플랑베르주(Flamberge)'는 프랑스어 명칭이고, 독일어로는 '플람베르크(Flamberg)' 또는 '플라멘슈베르트(Flammenschwert)'라 한다.

<단검>
런들대거 - rondel dagger. roundel dagger라고도 쓴다. 런들, 론델, 라운들 등등으로 읽는다.
망고슈 - 중세 후기에서 르네상스 시대에 사용하던 방어용 단검을 뜻한다. 영국에서는 패링 대거(Parring Dagger)라고 불렀다.
배즐러드 - 분류상으로는 도검의 일종이지만 단검의 하나로 알려져 있다. 칼날 끝부분이 손잡이 끝부분과 마찬가지로 막대기 모향으로 평행을 이루는 단검
스틸레토 - 이탈리아에서 15세기 무렵에 발전하여 16~17세기에 크게 유행한 단검의 일종이다. 검신이 가늘고 길며 끝이 매우 뾰족하여 검이 갑옷의 틈새를 파고들어가 깊은 곳까지 관통할 수 있어서 찌르는 무기로 사용되었다.
페스카즈 - 페르시아와 북부 인도 고유의 단검이다. 키용 부근에서 T자로 뒤집어져 있으며 날 전체는 S자 모양으로 구부러져 있다. 한쪽 날이지만 끝 부분은 예리하다. 

<둔기>
배틀액스 - Battle Axe, 전투 도끼. 도구인 도끼를 인마살상용 전쟁무기로 개량한 무기이다. 공구용 도끼보다 도끼 머리 부분의 크기와 무게는 작지만 날의 길이는 길며, 도끼날이 얇고 예각인 것이 특징이다.
워해머 - 전투용으로 쓰이는 망치를 일컫는 말이다.
쿼터스태프 - 물푸레나무, 참나무 등 단단한 나무를 깎아 만든 중세 유럽의 무기.

<창>
랜스 - Lance. 창. 거대한 원뿔형태를 한 창으로, 손으로 겨누고 겨드랑이로 고정할 수 있도록 뒷부분이 짧게 설계되어 있다.
파이크 - 일반적인 창의 길이를 비약적으로 늘린 형태로, 그 전시대 장창이 보통 3~4미터 정도였던데 반해, 파이크는 5~6미터에 이르렀다.
버디슈 - 긴 자루 끝에 초승달 모양의 도끼날을 달아둔 형상의 무기이며, 이 때문에 크레센트 액스(Crescent axe)라 불리는 경우도 있다.
빌 - 넓고 큰 날이 달린 폴암으로 걸어 당겨 베는 것이 특징인 장병기.
파르티잔(스피툼) - 기원은 13세기이며 기본적으로는 창날 밑동에 칼날을 세운 날개 두 개가 튀어나온 형태이다.
파르티잔(란세어) - 창날에 날을 세우지 않은 두 개의 막대기가 도검의 크로스 가드처럼 튀어나와 있다. 
파르티잔 - 기원은 양쪽에 도끼 날이 달린 할버드의 형상에서 비롯되었다고 하며, 그 형태상의 특징도 양쪽에 도끼가 붙은 듯한 형상이 구분 포인트이다. 
워사이드 - 대낫이 개량되어 전투에 적합한 형태가 된 것이 서양의 폴암 중 하나인 워 사이드
폴액스 - 14~15세기 중세 유럽에서 널리 사용한 긴 자루를 단 도끼 형태를 한 폴암의 한 종류


<방패>
라운드실드 - 고대부터 사용된 방패로 그리스 중장 보병의 호플론과 로마 군단병의 파르마에서 중세의 타지와 버클러까지 포함하는 넓은 개념의 방어구이다.
버클러 - 직경 또는 둘레가 30cm정도 되는 원형, 사각형 소형 방패의 통칭
타지 - 중세 유럽에서 사용되었던, 손으로 들지 않고 대신 팔뚝에 매달아 둔다던지 하는 식으로 팔에 걸쳐서 사용하는 형태의 소형 방패이다.
카이트실드 - 중세 초기에 유럽 각지에서 사용한 가오리연과 비슷하게 생긴 방패이다.
히터실드 - 10세기 중엽부터 등장한 외형은 카이트 실드의 위아래를 짧게 자른듯한 축소형 중세 유럽의 방패. 
스쿠툼 - 목제 방패로, 타원형과 직사각형 모양의 로마군이 장비한 제식 방패
타워실드 - 방패 중에서도 직사각형 형태의 대형 방패를 타워 실드라고 부른다.
파비스 - 중세 유럽의 전쟁에서 궁병이나 쇠뇌병들이 사용한 대형방패의 일종. 방패 가운데에 있는 툭 튀어나온 부분은 말뚝을 땅에 박고 쉽게 고정시킬 수 있게 만들어진 홈이다.

<기타>
너클 - 뾰족한 돌기가 있는 금속의 맨손무기





편곤(플레일) - 편곤(鞭棍)은 중국 서방 이민족의 기병 무기로부터 기원된 도리깨와 비슷한 형태의 무기이다.

<기타>
채찍 - 무기의 일종. 자루에 긴 채찍 끈이 달린 형태가 주된 모양이나 회초리 같은 모양을 하고 있는 것도 있다. 